programme -> program
colouring -> coloring
theatre -> theater
colour -> color
leechman -> leachman
wwf -> wwe
aeroplane -> airplane
performet=rs -> performers
organisation -> organization
travelling -> traveling
childrens -> children
rubix -> rubik
discusing -> discussing
fastly -> fast
explaning -> explaining
kreuger -> krueger
vedio -> video
coversation -> conversation
practising -> practicing
explaing -> explaining
diffrent -> different
coloured -> colored
photoes -> photos
oragami -> origami
advertisment -> advertisement
receipe -> recipe
volkswagon -> volkswagen
ingrediants -> ingredients
flys -> flies
rubicks -> rubik
programm -> program
modelling -> modeling
commerical -> commercial
motorcyle -> motorcycle
murry -> murray
kabadi -> kabaddi
spongbob -> spongebob
rubic -> rubik
fued -> feud
vehical -> vehicle
thier -> their
audiance -> audience
colours -> colors
colourful -> colorful
balck -> black
secssion -> session
explayning -> explaining
maths -> math
stiring -> stirring
swiming -> swimming